NO bonus_images/blood1.xpm
SO bonus_images/blood2.xpm
WE bonus_images/blood3.xpm
EA bonus_images/blood4.xpm
D bonus_images/blood5.xpm



F 102,0,0
C 64,64,64





111111111111111111111111111
  11110000000000000000000001
  1000000000000001000000001
 1000000000000000000000001
1000000010000111100000001
 10000000000001D1110000001
 1000000000000000000000001
  1100000000010000000000001
  10000000000D0000000000001
 1000000000001000000000001
10000000000000000000000001
 11000001000000000001100001
  1000000100000000000000001
   1000000000000000000000001
  1000100000000000000000001
 10000D0000000000000000001
 1000010000000001000000001
 100000000000000D000000001
  1000000000000010000000001
   100000001D100000000000001
  1000000000000000000000001
 10000000000N0000000000001
  1111111111111111111111111