NO bonus_images/na1.xpm
SO bonus_images/na2.xpm
WE bonus_images/na3.xpm
EA bonus_images/na4.xpm
D bonus_images/door.xpm
F 102,0,0
C 64,64,64

111111111111111111111
101000001000000000001
101010101011111110001
100010100010000010001
111110101111101011101
100000101000101000001
10111110D011101111111
101000001010100000101
101011111010111110101
101010001010100010101
101110101010101010101
100000101010001010001
111111101011111011101
10000010D000100010001
101110101110101110111
101000100000100010101
101011D11111111010101
100010000000000010001
10D010111011111111101
1N1000001000000000001
111111111111111111111