NO bonus_images/hitler1.xpm
SO bonus_images/hitler2.xpm
WE bonus_images/hitler3.xpm
EA bonus_images/hitler4.xpm
D bonus_images/hitler5.xpm
F 102,0,0       
C 64,64,64          

111111111111111111111
101000001000000000001
101010101011111110001
100010100010000010001
111110101111101011101
100000101000101000001
10111110D011101111111
101000001010100000101
101011111010111110101
101010001010100010101
101110101010101010101
100000101010001010001
111111101011111011101
10000010D000100010001
101110101110101110111
101000000000100010101
101111D11111111111111
100010000000000010001
100010111011111111101
1N1000001000000000001
111111111111111111111
