NO images/map1.xpm
WE images/map2.xpm
EA images/map3.xpm
SO images/map4.xpm
F 39, 55, 70
C 121, 125,   127


111111111111111111111111111111111111111111111111
                                                1
                                                 1
                                                  1111111111111111111111111111111111111
                                                    100000000000000000000000000000000001
                                                   10011111111111110000000000000000000001
                                                   1001           11000000000000000000011
                                                   1001           11100000000000000000111
                                                   1001           11110000000000000001111
                                                   1001           11111000000000000011111
                                                   1001           11111100000000000111111
                                                 111001           11111110000000001111111
                                                1000001           11111111000000011111111
                                               10011001           11111111100000111111111
                                              1001 1001           11111111110001111111111
1111111111111111111111111111111111111111111111001  1001           11111111111011111111111
1N0000110000000000011000000000000000000000000001   1001           10000000000000000000001
10000001100000000011000000000000000000000000001    1001           10000000000000000000001
10000000110000000110000000000000000000000000001    1001           10000000000000000000001
10000000011000001100000000000000000000000000001    1001           10000000000000000000001
10000000001100011000000000000000000000000000001    1001           10000000000000000000001
10000000000110110000000000000000000000000000001    1001           10000000000000000000001
10000000000110110000000000000000000000000000001    1001           10000000000000000000001
10000000000000000000000000000000000000000000001    1001           10000000000000000000001
10000000000110110000000000000000000000000000001111110011111111111110000000000000000000001
10000000001100011000000000000000000000000000000000000000000000000000000000000000000000001
10000000011000001100000000000000000000000000001111110011111111111110000000000000000000001
10000000110000000110000000000000000000000000001    1001           10000000000000000000001
10000001100000000011000000000000000000000000001    1001           10000000000000000000001
10000011000000000001100000000000000000000000001    1001           10000000000000000000001
1000000000000000000000000000000000000000000001     1001            100000000000000000001
111111111111111111111001111111111111111111111      1001             1111111111111111111
                    1001                           1001
                    1001                           1001
                    1001                           1001
                    1001                           1001
                    1001                           1001
                    1001                           1001
                    10011111111111111111111111111111001
                    10000000000000000000000000000000001
                     100000000000000000000000000000001
                      1111111111111111111111111111111