NO images/paint.xpm
WE images/paint1.xpm
EA images/paint3.xpm
SO images/paint4.xpm

C 204,102,0
F 102,102,0

11111111111111111111
10001001110101011011
10100011111101111011
11101000000000000011
10101101100101010011
10000110100101110001
10011000010000001001
10100100000001100001
10101101100010010101
11000001010101001111
11110101110111001001
10010000111011011011
10000010100110011001
10101010100011100101
1011000N001011001111
10011110011100001111
10000001001110100001
11111100001111010011
10001101101100101001
11111111111111111111